20|dvadsať
devětadvacetiprocentní|dvadsaťdeväťpercentný
dva`2|dva
dvaadvacetihodinový|dvadsaťdvahodinový
dvaadvacetiprocentní|dvadsaťdvapercentný
dvaaosmdesátiprocentní|osemdesiatdvapercentný
dvaapadesátiprocentní|päťdesiatdvapercentný
dvaasedmdesátiřádkový|sedemdesiatdvariadkový
dvaatřicetibitový|tridsaťdvabitový
dvaatřicetibytový|tridsaťdvabytový
dvaatřiceticiferný|tridsaťdvaciferný
dvaatřicetimístný|tridsaťdvamiestny
dvaatřicetiprocentní|tridsaťdvapercentný
dvaatřicetiprvkový|tridsaťdvaprvkový
dvaatřicetipísmenkový|tridsaťdvapísmenkový
dvaatřicetipísmenný|tridsaťdvapísmenný
dvaatřicetipísmenový|tridsaťdvapísmenový
dvaatřicetislabikový|tridsaťdvaslabikový
dvaatřicetislabičný|tridsaťdvaslabičný
dvaatřicetisloupcový|tridsaťdvastĺpcový
dvaatřicetiznakový|tridsaťdvaznakový
dvaatřicetiřádkový|tridsaťdvariadkový
dvaačtyřicetiprocentní|štyridsaťdvapercentný
dvaašedesátiprocentní|šesťdesiatdvapercentný
dvacatery|dvadsatoro
dvacaterý|dvadsatoraký
dvacet`20|dvadsať
dvacetiargumentový|dvadsaťargumentový
dvacetibitový|dvadsaťbitový
dvacetibodový|dvadsaťbodový
dvacetibytový|dvadsaťbytový
dvacetice|dvadsatica
dvaceticiferný|dvadsaťciferný
dvacetihaléř|dvadsaťhaliernik
dvacetihodinový|dvadsaťhodinový
dvacetikoruna|dvadsaťkorunáčka
dvacetikorunový|dvadsaťkorunový
dvacetiletý|dvadsaťročný
dvacetimiliónový|dvadsaťmiliónový
dvacetimilióntý|dvadsaťmiliónty
dvacetiminutový|dvadsaťminútový
dvacetimístný|dvadsaťmiestny
dvacetina|dvadsatina
dvacetinásobek|dvadsaťnásobok
dvacetiprocentní|dvadsaťpercentný
dvacetiprvkový|dvadsaťprvkový
dvacetipísmenkový|dvadsaťpísmenkový
dvacetipísmenný|dvadsaťpísmenný
dvacetipísmenový|dvadsaťpísmenový
dvacetislabikový|dvadsaťslabikový
dvacetislabičný|dvadsaťslabičný
dvacetisloupcový|dvadsaťstĺpcový
dvacetistup|dvadsaťstup
dvacetistupňový|dvadsaťstupňový
dvacetistěn|dvadsaťsten
dvacetitisícový|dvadsaťtisícový
dvacetitisící|dvadsaťtisíci
dvacetiznakový|dvadsaťznakový
dvacetiřádkový|dvadsaťriadkový
dvacetkrát|dvadsaťkrát
dvacetnický|dvadsiatnický
dvacetník|dvadsiatnik
dvacet|dvadsať
dvacátý|dvadsiaty
dvacítka|dvadsiatka
dvacítkový|dvadsiatkový
dvakrát`2|dvakrát
dvakrát|dvakrát
dvanácterníka|dvanástnik
dvanáctero|dvanástoro
dvanácterák|dvanástorák
dvanácterý|dvanástoraký
dvanáctiargumentový|dvanásťargumentový
dvanáctibitový|dvanásťbitový
dvanáctibodový|dvanásťbodový
dvanáctibytový|dvanásťbytový
dvanáctice|dvanástica
dvanácticiferný|dvanásťciferný
dvanáctidenní|dvanásťdenný
dvanáctihodinový|dvanásťhodinový
dvanáctiletý|dvanásťročný
dvanáctiminutový|dvanásťminútový
dvanáctimístný|dvanásťmiestny
dvanáctiměsíční|dvanásťmesačný
dvanáctina|dvanástina
dvanáctinásobek|dvanásťnásobok
dvanáctiprocentní|dvanásťpercentný
dvanáctiprvkový|dvanásťprvkový
dvanáctipísmenkový|dvanásťpísmenkový
dvanáctipísmenný|dvanásťpísmenný
dvanáctipísmenový|dvanásťpísmenový
dvanáctislabikový|dvanásťslabikový
dvanáctislabičný|dvanásťslabičný
dvanáctisloupcový|dvanásťstĺpcový
dvanáctistrunný|dvanásťstrunný
dvanáctistup|dvanásťstup
dvanáctistupňový|dvanásťstupňový
dvanáctistěn|dvanásťsten
dvanáctiválcový|dvanásťvalcový
dvanáctiválec|dvanásťvalec
dvanáctiznakový|dvanásťznakový
dvanáctiúhelník|dvanásťuholník
dvanáctiřádkový|dvanásťriadkový
dvanáctka|dvanástka
dvanáctkový|dvanástkový
dvanáctkrát|dvanásťkrát
dvanáct|dvanásť
dvanáctý|dvanásty
dva|dva
jedenadvacetihodinový|dvadsaťjedenhodinový
jedenadvacetiprocentní|dvadsaťjedenpercentný
jedva|len
ledva|len
ledvaže-1|ledvaže
naobědvat|naobedovať
obojí|obidva
obědvat|obedovať
odvaděč|odvádzač
odvaha|odvaha
odvahový|odvahový
odvalitelný|odvaliteľný
odvalit|odvaliť
odvalovat|odvaľovať
odval|odval
odvanout|odvanúť
odvar|odvar
odvazovat|odväzovať
odvařitelný|odvariteľný
odvařit|odvariť
odvařovat|odvarovať
odvažovat|odvažovať
osmadvacetiprocentní|dvadsaťosempercentný
podval|podval
podvarianta|podvariant
podvariantový|podvariantový
podvazek|podväzok
podvazkový|podväzkový
podvazovat|podväzovať
podvaz|podväz
poobědvat|poobedovať
pětadvacetiprocentní|dvadsaťpäťpercentný
předvaha|predvaha
předvařitelný|predvariteľný
předvařit|predvariť
předvařovat|predvarovať
sedmadvacetiprocentní|dvadsaťsedempercentný
stodvacetiletý|stodvadsaťročný
třiadvacetihodinový|dvadsaťtrihodinový
třiadvacetiprocentní|dvadsaťtripercentný
xxoba|obidva
čtyřiadvacetihodinový|dvadsaťštyrihodinový
čtyřiadvacetiprocentní|dvadsaťštyripercentný
šestadvacetiprocentní|dvadsaťšesťpercentný
jeden`1|jeden
jedenadvacetihodinový|dvadsaťjedenhodinový
jedenadvacetiprocentní|dvadsaťjedenpercentný
jedenapůlkrát|jedenapolkrát
jedenapůlnásobek|jedenapolnásobok
jedenapůlprocentní|jedenapolpercentný
jedenapůl|jedenapol
jedenatřicetiprocentní|tridsaťjedenpercentný
jedenkrát`1|jedenkrát
jedenkrát|jedenkrát
jeden|jeden
jedenáctero|jedenástoro
jedenácterý|jedenástoraký
jedenáctiargumentový|jedenásťargumentový
jedenáctibitový|jedenásťbitový
jedenáctibodový|jedenásťbodový
jedenáctibytový|jedenásťbytový
jedenáctice|jedenástica
jedenácticiferný|jedenásťciferný
jedenáctidenní|jedenásťdenný
jedenáctihodinový|jedenásťhodinový
jedenáctiletka|jedenásťročenka
jedenáctiletý|jedenásťročný
jedenáctiminutový|jedenásťminútový
jedenáctimístný|jedenásťmiestny
jedenáctiměsíční|jedenásťmesačný
jedenáctina|jedenástina
jedenáctinásobek|jedenásťnásobok
jedenáctiprocentní|jedenásťpercentný
jedenáctiprvkový|jedenásťprvkový
jedenáctipísmenkový|jedenásťpísmenkový
jedenáctipísmenný|jedenásťpísmenný
jedenáctipísmenový|jedenásťpísmenový
jedenáctislabikový|jedenásťslabikový
jedenáctislabičný|jedenásťslabičný
jedenáctisloupcový|jedenásťstĺpcový
jedenáctistupňový|jedenásťstupňový
jedenáctiznakový|jedenásťznakový
jedenáctiřádkový|jedenásťriadkový
jedenáctka|jedenástka
jedenáctkový|jedenástkový
jedenáctkrát|jedenásťkrát
jedenáct|jedenásť
jedenáctý|jedenásty
jednapadesátiprocentní|päťdesiatjedenpercentný
jednašedesátiprocentní|šesťdesiatjedenpercentný
blackburn|blackburn
blackwell-1|blackwell
black|black
blansko|blansko
blažej|blažej
casablanca|casablanca
hausenblas|hausenblas
ablativní|ablatívny
ablativ|ablatív
bezoblačný|bezoblačný
blafal|táraj
blafnout|blafnúť
blaf|bluf
blahobytný|blahobytný
blahobyt|blahobyt
blahodárný|blahodarný
blahopřejný|blahoprajný
blahopřát|blahopriať
blahosklonný|blahosklonný
blahoslavit|blahoslaviť
blahoslav|blahoslav
blahovolný|blahovoľný
blahovůle|blahovôľa
blaho|blaho
blahořečitelný|blahorečiteľný
blahořečit|blahorečiť
blahý|blahý
blamovat|blamovať
blamáž|blamáž
blanitý|blanitý
blanka|blanka
blanket|blanketa
blankytný|blankytný
blankyt|blankyt
blanokřídlý|blanokrídly
blasfemický|blasfemický
blasfémie|blasfémia
blatník|blatník
blatouch|záružlie
blaze|blaho
blažitelný|blažiteľný
blažit|blažiť
blaživý|blaživý
blána|blana
blátivý|blativý
bláto|blato
brblat|brblať
bublanina|bublanina
bublaninový|bublaninový
bublat|bublať
bublavý|bublavý
nadoblačný|nadoblačný
nitroblána|vnútroblana
nitroblánový|vnútroblanový
oblafnout|oblafnúť
oblak|oblak
oblastní|oblastný
oblast|oblasť
oblačno-1|oblačno
oblačno-2|oblačno
oblačný|oblačný
oblažitelný|oblažiteľný
oblažit|oblažiť
oblažovat|oblažovať
odblanitelný|odblaniteľný
odblanit|odblaniť
odblaňovat|odblaňovať
poblahopřát|poblahopriať
podoblast|podoblasť
rozblátitelný|rozblatiteľný
rozblátit|rozblatiť
tablet|tabla
zablahořečitelný|zablahorečiteľný
zablahořečit|zablahorečiť
zablátitelný|zablatiteľný
zablátit|zablatiť
škrablavý|škrabľavý
žblabuňka-1|bublina
atestovat|atestovať
atest|atest
autotest|autotest
otestovaný|otestovaný
otestovat|otestovať
otestování|otestovanie
protestace|protestácia
protestantismus|protestantizmus
protestantský|protestantský
protestant|protestant
protestační|protestačný
protestní|protestný
protestovat|pretestovať
protestovat|protestovať
protest|protest
přetestovat|pretestovať
rychlotest|rýchlotest
testace|testácia
testamentovat|testamentovať
testament|testament
testamentární|testamentárny
testovací|testovací
testovaný|testovaný
testovat|testovať
testování|testovanie
testový|testový
testující|testujúci
test|test
testérský|testérsky
testér|testér
zaprotestovat|zaprotestovať
